##################################
#               ##      #      F #
#           ##      #     #      #
#    * *     #####################
#    * *     #          *** $    #
#    * *     #  *****            #
#            #           ^       #
#                                #
#            ###########         #
#            #   *     #    *    #
#      ***   #   *     #    *    #
#            #   *     #         #
#            #         #         #
#   %        #         D         #
##################################