########################################################
#                                                      #
#                                           F          #
#                 *                                    #
#                                                      #
#      ^                                               #
#                                           ^          #
#                                                      #
#            ###########         $                     #
#            #         #                           *   #
#            #         #                               #
#            #   #D#   D                               #
#            #   #*#   #                  *            #
#            ###########                               #
#                                                      #
#                                                      #
#                                                      #
#                                                      #
#                                                      #
#                                   F                  #
#  %                                               *   #
########################################################