########################################################
#                                                      #
#                                           F          #
#                 *               ^                    #
########################                               #
#                      #                               #
#       ***    $       #                    ^          #
#                      #                               #
################  ######         $                     #
#                      #                           *   #
#                      #                               #
# ^                    D                               #
#                      #                  *            #
##############     #####                               #
#       ***            #                               #
#                      #    ^                          #
########################                               #
#                                                      #
#                                                      #
#                                   F            $     #
#  %                                               *   #
########################################################